29,29,29,29,29,29,29,29,29,29,29,29,29,29,29
29,29,29,29,29,29,29,29,29,29,29,29,29,29,29
29,29,30,29,29,29,29,29,29,29,29,29,30,29,29
29,29,30,30,29,29,29,29,29,29,29,30,30,29,29
29,29,29,30,30,29,29,29,29,29,30,30,29,29,29
29,29,29,29,30,30,29,29,29,30,30,29,29,29,29
29,29,29,29,29,30,30,29,30,30,29,29,29,29,29
29,29,29,29,29,29,30,30,30,29,29,29,29,29,29
29,29,29,29,29,29,29,30,29,29,29,29,29,29,29
29,29,29,29,29,29,29,30,29,29,29,29,29,29,29
29,29,29,29,29,29,29,30,29,29,29,29,29,29,29
29,29,29,29,29,29,29,30,29,29,29,29,29,29,29
29,29,29,29,29,29,29,30,29,29,29,29,29,29,29
29,29,29,29,29,29,29,29,29,29,29,29,29,29,29
29,29,29,29,29,29,29,29,29,29,29,29,29,29,29
