29,29,29,29,29,29,29,29,29,29,29,33,33,33,33,33
29,29,29,29,29,29,29,29,29,29,29,33,33,33,33,33
29,29,33,33,33,29,29,29,29,29,29,29,29,29,33,33
29,29,33,33,33,29,29,29,29,29,29,29,29,29,33,33
29,29,33,33,33,29,29,29,29,29,29,29,29,29,33,33
29,29,33,33,33,29,29,29,29,33,29,29,29,29,29,29
29,29,29,29,29,29,29,29,29,29,29,29,29,29,29,29
29,29,29,29,29,29,29,29,29,29,29,29,29,29,29,29
